1111111111111111111111111111111
1E0000000000000C00000C000000001
1010010100100000101001000000011
101001001010101000100100000C011
1P0000000C00C000000000000000001
1000000000000000000000000000001
100000000000000C00000C0000001
1010010100100000101001000000011
101001001010101000100100000C011
100000000C00C000000000000000001
1111111111111111111111111111111